Shlomi Amiga – shlomi@shlomiamiga.com
Scarlet O'Neill - scarlet@scarletoneill.com
Annuj Yoganathan - impressionsbyannuj@gmail.com
Erika Hammer - info@ten2tenphotography.com
Lisa Mark - lisa@lisamarkphotography.com
David Buck - david@davidbuckweddings.com
Jessy Pesce - jessypesce@gmail.com
Marcin Moka - marcin@marcinmoka.com
Assaf Friedman - assaffriedman@yahoo.com
Jessica Bossé - hello@daringwanderer.com
Niv Shimshon - info@nivshimshon.com
Celine Kim - celine@celinekim.com
Michael Rosseau - info@michaelrousseau.ca
Vanessa Paxton - vanessapaxton@hotmail.com
Scott Williams - scott@scottwilliamsphotographer.com
Danijela Pruginic - hello@danijelaweddings.com
Julius & James - www.juliusandjames.com
Aisling Turtle - aisling.claire@oakandmyrrh.com
Aron Goss - aron@arongoss.com
Melissa Sung - hello@melissasung.com
Rudo Vacula - contact@torontoweddingstudios.com
James Paul Correia - info@jamespaulcorreia.com
Anita Cheung - info@rhythm-photography.com
Sam Wong - info@visualcravings.com
Kymberlie Dozois - info@kymberliedozois.com
Jennifer Ballard - info@jennifer-ballard.com
Jenn & Dave Stark - stark.jennifer@gmail.com
Steven Chung - info@glistenphotography.com
Sarah Andrews - info@sarahandrews.photo
Rebecca Wagler - weethreesparrows@gmail.com
Nathaniel Dionisio - info@natedionisio.com
Shelly Spithoff - shelly@shellyspithoff.com
Sheldon Parsons - shell33@bell.net
Lyn Ismael - lyn@lynismael.com
Rochelle Bragg & Stephanie Ironside - ironbraggphoto@gmail.com
Jessica & Shane Edwards - jessica@jsephotos.com
Kasia Dunn - kasiadunn@yahoo.ca
Anastasia Giaouris - info@olivephotography.ca
Ranya Alsabti - info@ranyalsabti.com
Yohan Chung - info@yohanchung.com
Gillian Foster - info@gillianfoster.ca
Laura Nicholson - laura@lnphotography.ca
Katarina & Hugh - boakviewphoto@gmail.com
Paul O’Neil - mail@pauloneil.com
Jo Haley - info@haleyphotography.ca
Henny Hwang - info@hennygraphy.com
Callum Pinkney - info@callumpinkney.com
Paula Visco - paula@paulavisco.com
Catherine Farquharson - catherine@documentographer.com